1111111111111111111
101P100000000000C01
100000X1100011X0001
1000001C10000110011
1001000000X10000011
1110000100001011011
1000001CX1000000011
1C1X00000000C000011
110001111100C0X0001
10010000C1010001001
101110X010011000001
10010110X0011100001
10X01C001100110XXX1
1C10000000000001E11
1111111111111111111
