111111111111111111111111
1000000000011000000000P1
100011100001100011100001
10011CC0000110011CC00001
100111100001100111100001
100011100001100011100001
100010100001000010100001
1000000000010000000000E1
111111111111111111111111
