111111111111111111111111
1000000000011000000001P1
100011100001100011100001
10011CC0000110011CC00001
100111100001100111100001
100011100001100011100000
100010100011110010100001
1000000010000001000001E1
111111111111111111111111