111111111111111111111111
1P00000000011000000000E1
100011100001100011100001
10011CC0000110011CC00001
100111100001100111100001
100011100001100011100001
100010100001100010100001
100000000000000000000001
111111111111111111111111
