1111111111111111
1100000P00000011
1010000000111001
1010000001000101
1010100000001001
1011111000100001
1000100001111101
1000000C00000001
1111111111111111
1000000000000001
1001110000000001
101CCC1000000001
101C000000000001
101CCC1000000001
1001110000000001
110000001E100011
1111111111111111
