1111111111111111111
101P100000000000C01
100000M1100011M0001
1000001C10000110011
1001000000M10000011
1110000100001011011
1010001CM1000000011
1C1M00000000C000011
110001111100C0M0001
10010000C1010001001
101110M010011000X01
1X010110M0011100001
10M01C001100110MMM1
1C10000000000001E11
1111111111111111111
