11111
1C1P1
10001
101E1
11111
